game601-Escape
An Interactive Fiction by Sam Smyth
Release 1 / Serial number 201116 / Inform 7 build 6M62 (I6/v6.33 lib 6/12N) SD

Escape Room
You are in an Escape Room. The room is mostly bare. There are three doors: one to the North, one to the East, and one to the West. There is no door on the South wall. A table sits in the middle of the room.

On the table is a box.

>take key
Taken.

>take table
Taken.

>lmao
That's not a verb I recognise.

* * *

game601-Escape
An Interactive Fiction by Sam Smyth
Release 1 / Serial number 201116 / Inform 7 build 6M62 (I6/v6.33 lib 6/12N) SD

Escape Room
You are in an Escape Room. The room is mostly bare. There are three doors: one to the North, one to the East, and one to the West. There is no door on the South wall. A table sits in the middle of the room.

On the table is a box.

>go east
Chest Room
You open the East door to reveal a small room.

There is a small chest is the center of the room. It has no markings.

A key sits on top of the chest.

>got East
That's not a verb I recognise.

* * *

game601-Escape
An Interactive Fiction by Sam Smyth
Release 1 / Serial number 201116 / Inform 7 build 6M62 (I6/v6.33 lib 6/12N) SD

Escape Room
You are in an Escape Room. The room is mostly bare. There are three doors: one to the North, one to the East, and one to the West. There is no door on the South wall. A table sits in the middle of the room.

On the table is a box.

>examine south wall
A wall inscribed with the letter S. There is a small key hole in the middle of the S.

>west door
I only understood you as far as wanting to (go) west.

>west
(first opening West Door)
It seems to be locked.

>east
(first opening East Door)
It seems to be locked.

>south
(first opening South Wall)
It seems to be locked.

* * *

game601-Escape
An Interactive Fiction by Sam Smyth
Release 1 / Serial number 201116 / Inform 7 build 6M62 (I6/v6.33 lib 6/12N) SD

Escape Room
You are in an Escape Room. The room is mostly bare. There are three doors: one to the North, one to the East, and one to the West. There is no door on the South wall. A table sits in the middle of the room.

On the table is a box.

>look
Escape Room
You are in an Escape Room. The room is mostly bare. There are three doors: one to the North, one to the East, and one to the West. There is no door on the South wall. A table sits in the middle of the room.

On the table is a blue key.

>examine door
Which do you mean, West Door, East Door or North Door?

* * *

>look
Escape Room
You are in an Escape Room. The room is mostly bare. There are three doors: one to the North, one to the East, and one to the West. There is no door on the South wall. A table sits in the middle of the room.

On the table is a blue key.

>examine key
There is a lone key on the table. It is marked with the letter S.

>take key
Taken.

* * *

game601-Escape
An Interactive Fiction by Sam Smyth
Release 1 / Serial number 201116 / Inform 7 build 6M62 (I6/v6.33 lib 6/12N) SD

Escape Room
You are in an Escape Room. The room is mostly bare. There are three doors: one to the North, one to the East, and one to the West. There is no door on the South wall. A table sits in the middle of the room.

On the table is a box.

>examine table
A table in the middle of the room. There is a box on the table.

On the table is a box.

>look
Escape Room
You are in an Escape Room. The room is mostly bare. There are three doors: one to the North, one to the East, and one to the West. There is no door on the South wall. A table sits in the middle of the room.

On the table is a box.

>take table
The table is bolted to the ground.

>take box
You pick up the box. Inside is a blue key. You take the blue key and put it in your pocket.

>take box
You want to take the box but it is useless.

>examine wall
A wall inscribed with the letter S. There is a small key hole in the middle of the S.

>examine key
A blue key. It is marked with the letter S.

>unlock wall
(with the blue key)
You unlock the South Wall.

>go south
(first opening the South Wall)

Blue Room
You open the South Wall to reveal a small Blue Room.

A purple key hangs from a string in the middle of the room.

>take purple key
Taken.

>examine key
Which do you mean, the purple key or the blue key?

>purple key
A purple key. There is a W inscribed on the handle.

>go north
Escape Room
You are in an Escape Room. The room is mostly bare. There are three doors: one to the North, one to the East, and one to the West. There is no door on the South wall. A table sits in the middle of the room.

On the table is a box.

* * *

game601-Escape
An Interactive Fiction by Sam Smyth
Release 1 / Serial number 201116 / Inform 7 build 6M62 (I6/v6.33 lib 6/12N) SD

Escape Room
You are in an Escape Room. The room is mostly bare. There are three doors: one to the North, one to the East, and one to the West. There is no door on the South wall. A table sits in the middle of the room.

On the table is a box.

>examine box
A small wooden box.

>take box
You pick up the box. Inside is a blue key. You take the blue key and put it in your pocket.

>inventory
You are carrying:
  a blue key

>look
Escape Room
You are in an Escape Room. The room is mostly bare. There are three doors: one to the North, one to the East, and one to the West. There is no door on the South wall. A table sits in the middle of the room.

On the table is a box.

>examine door
Which do you mean, West Door, East Door or North Door?

>West Door
A door inscribed with the letter W.

>open West Door
It seems to be locked.

>unlock South Wall
(with the blue key)
You unlock the South Wall.

>go south
(first opening the South Wall)

Blue Room

>go north
Escape Room
You are in an Escape Room. The room is mostly bare. There are three doors: one to the North, one to the East, and one to the West. There is no door on the South wall. A table sits in the middle of the room.

On the table is a box.

>take the box
You want to take the box but it is useless.

* * *

game601-Escape
An Interactive Fiction by Sam Smyth
Release 1 / Serial number 201116 / Inform 7 build 6M62 (I6/v6.33 lib 6/12N) SD

Escape Room
You are in an Escape Room. The room is mostly bare. There are three doors: one to the North, one to the East, and one to the West. There is no door on the South wall. A table sits in the middle of the room.

On the table is a box.

>take box
You pick up the box. Inside is a blue key. You take the blue key and put it in your pocket.

>take table
The table is bolted to the ground.

>look
Escape Room
You are in an Escape Room. The room is mostly bare. There are three doors: one to the North, one to the East, and one to the West. There is no door on the South wall. A table sits in the middle of the room.

On the table is a box.

>examine wall
A wall inscribed with the letter S. There is a small key hole in the middle of the S.

>unlock wall
(with the blue key)
You unlock the South Wall.

>go south
(first opening the South Wall)

Blue Room
You open the South Wall to reveal a small Blue Room. There is a purple key hanging from a string in the middle of the room.

>take key
You already have that.

>take purple key
You can't see any such thing.

* * *

>take box
You pick up the box. Inside is a blue key. You take the blue key and put it in your pocket.

>unlock wall
(with the blue key)
You unlock the South Wall.

* * *

>go south
(first opening the South Wall)

Blue Room
You open the South Wall to reveal a small Blue Room.

A purple key hangs from a string in the middle of the room.

>take key
(the purple key)
Taken.

>take purple key
That's hardly portable.

* * *

>take key
(the purple key)
Taken.

>go norht
You can't see any such thing.

>go north
Escape Room
You are in an Escape Room. The room is mostly bare. There are three doors: one to the North, one to the East, and one to the West. There is no door on the South wall. A table sits in the middle of the room.

On the table is a box.

>unlock west door
What do you want to unlock West Door with?

>purple key
You unlock West Door.

>go west
(first opening West Door)

Chest Room
You open the West Door to reveal a small room.

There is a small golden chest is the center of the room. It has no markings.

A green key sits on top of the chest.

>take green key
Taken.

>go east
Escape Room
You are in an Escape Room. The room is mostly bare. There are three doors: one to the North, one to the East, and one to the West. There is no door on the South wall. A table sits in the middle of the room.

On the table is a box.

>unlock east door
What do you want to unlock East Door with?

>green key
You unlock East Door.

>go east
(first opening East Door)

Light Room
You open the East Door to reveal a blindingly lit room. You cover your eyes and look around.

A golden key shines in the center of the room.

>take golden key
Taken.

>go west
Escape Room
You are in an Escape Room. The room is mostly bare. There are three doors: one to the North, one to the East, and one to the West. There is no door on the South wall. A table sits in the middle of the room.

On the table is a box.

>go west
Chest Room
You open the West Door to reveal a small room.

There is a small golden chest is the center of the room. It has no markings.

>unlock small chest
What do you want to unlock the small chest with?

>golden key
You unlock the small chest.

>look in chest
You can't see inside, since the small chest is closed.

>open chest
You open the small chest, revealing a red key.

>examine key
Which do you mean, the red key, the golden key, the green key, the purple key or the blue key?

>red key
A red key. Someone got lazy and just drew an N on it with sharpie.

>take red key
Taken.

>go east
Escape Room
You are in an Escape Room. The room is mostly bare. There are three doors: one to the North, one to the East, and one to the West. There is no door on the South wall. A table sits in the middle of the room.

On the table is a box.

>unlock north door
What do you want to unlock North Door with?

>red key
You unlock North Door.

>go north
(first opening North Door)

Exit

* * *

>take purple key
Taken.

>go north
Escape Room
You are in an Escape Room. The room is mostly bare. There are three doors: one to the North, one to the East, and one to the West. There is no door on the South wall. A table sits in the middle of the room.

On the table is a box.

* * *

>purple key
You unlock West Door.

>lock west door
What do you want to lock West Door with?

>blue key
That doesn't seem to fit the lock.

>purple key
That's not a verb I recognise.

>go west
(first opening West Door)

Chest Room
You open the East door to reveal a small room.

There is a small golden chest is the center of the room. It has no markings.

A key sits on top of the chest.

>take key
(the green key)
Taken.

* * *

>purple key
You unlock West Door.

>go west
(first opening West Door)

Chest Room
You open the East door to reveal a small room.

There is a small golden chest is the center of the room. It has no markings.

A key sits on top of the chest.

* * *

>go west
Escape Room
You are in an Escape Room. The room is mostly bare. There are three doors: one to the North, one to the East, and one to the West. There is no door on the South wall. A table sits in the middle of the room.

On the table is a box.

>go east
Light Room
You open the East Door to reveal a blindingly lit room. You cover your eyes and look around.

>unlock small chest
You can't see any such thing.

>go west
Escape Room
You are in an Escape Room. The room is mostly bare. There are three doors: one to the North, one to the East, and one to the West. There is no door on the South wall. A table sits in the middle of the room.

On the table is a box.

* * *

>unlock small chest
What do you want to unlock the small chest with?

>golden keh
I only understood you as far as wanting to unlock the small chest with the golden key.

>golden key
That's not a verb I recognise.

>unlock small chest
What do you want to unlock the small chest with?

* * *

>go north
Escape Room
You are in an Escape Room. The room is mostly bare. There are three doors: one to the North, one to the East, and one to the West. There is no door on the South wall. A table sits in the middle of the room.

On the table is a box.

>unlockw est door
That's not a verb I recognise.

>purple key
That's not a verb I recognise.

>unlock west door
What do you want to unlock West Door with?

* * *

>golden key
You unlock the small chest.

>open chest
You open the small chest, revealing a red key.

>take red key
Taken.

* * *

>red key
You unlock North Door.

>go north
(first opening North Door)

    *** You step into the room. Balloons fall from the ceiling along with a banner that says CONGRATULATIONS! YOU ESCAPED! ***

Would you like to RESTART, RESTORE a saved game, QUIT or UNDO the last command?

* * *

>unlock wall
(with the blue key)
You unlock the South Wall.

>open south wall
You open the South Wall.

>go south
Blue Room
You open the South Wall to reveal a small Blue Room.

A purple key hangs from a string in the middle of the room.

>take purple key
Taken.

* * *

>go north
Escape Room
You are in an Escape Room. The room is mostly bare. There are three doors: one to the North, one to the East, and one to the West. There is no door on the South wall. A table sits in the middle of the room.

On the table is a box.

>unlock west doors
What do you want to unlock West Door with?

>purple key
You unlock West Door.

* * *

>go west
Chest Room
You open the West Door to reveal a small room.

There is a small golden chest is the center of the room. It has no markings.

>unlock small chest with golden key
You unlock the small chest.

>open small chest
You open the small chest, revealing a red key.

>take red key
Taken.

* * *

>go north
(first opening North Door)

Exit

>go north
You can't go that way.

* * *

>take box
You pick up the box. Inside is a blue key. You take the blue key and put it in your pocket.

>examine key
A blue key. It is marked with the letter S.

>look
Escape Room
You are in an Escape Room. The room is mostly bare. There are three doors: one to the North, one to the East, and one to the West. There is no door on the South wall. A table sits in the middle of the room.

On the table is a box.

>take box
You want to take the box but it is useless.

>go south
(first opening the South Wall)
It seems to be locked.

>unlock south wall
(with the blue key)
You unlock the South Wall.

>go south
(first opening the South Wall)

Blue Room
You open the South Wall to reveal a small Blue Room.

A purple key hangs from a string in the middle of the room.

* * *

>take purple key
Taken.

>inventory
You are carrying:
  a purple key
  a blue key

>go north
Escape Room
You are in an Escape Room. The room is mostly bare. There are three doors: one to the North, one to the East, and one to the West. There is no door on the South wall. A table sits in the middle of the room.

On the table is a box.

>go west
(first opening West Door)
It seems to be locked.

>unlock west door
What do you want to unlock West Door with?

* * *

>go west
(first opening West Door)

Chest Room
You open the West Door to reveal a small room.

There is a small golden chest is the center of the room. It has no markings.

A green key sits on top of the chest.

>take small chest
That's fixed in place.

>examine small chest
You see nothing special about the small chest.

>go back
You can't see any such thing.

>go east
Escape Room
You are in an Escape Room. The room is mostly bare. There are three doors: one to the North, one to the East, and one to the West. There is no door on the South wall. A table sits in the middle of the room.

On the table is a box.

>go east
(first opening East Door)
It seems to be locked.

>examine key
Which do you mean, the purple key or the blue key?

>go west
Chest Room
You open the West Door to reveal a small room.

There is a small golden chest is the center of the room. It has no markings.

A green key sits on top of the chest.

>take green key
Taken.

>examine key
Which do you mean, the green key, the purple key or the blue key?

>green key
A green key. An E is etched into the handle.

>go east
Escape Room
You are in an Escape Room. The room is mostly bare. There are three doors: one to the North, one to the East, and one to the West. There is no door on the South wall. A table sits in the middle of the room.

On the table is a box.

* * *

>take golden key
Taken.

>examine golden key
A golden key. It shines even when it is not in the light.

>go west
Escape Room
You are in an Escape Room. The room is mostly bare. There are three doors: one to the North, one to the East, and one to the West. There is no door on the South wall. A table sits in the middle of the room.

On the table is a box.

* * *

>go west
Chest Room
You open the West Door to reveal a small room.

There is a small golden chest is the center of the room. It has no markings.

>unlock golden chest
I didn't understand that sentence.

>unlock small chest
What do you want to unlock the small chest with?

* * *

>golden key
You unlock the small chest.

>examine small chest
You see nothing special about the small chest.

>look
Chest Room
You open the West Door to reveal a small room.

There is a small golden chest is the center of the room. It has no markings.

>take
(the small chest)
That's fixed in place.